PEMROGRAMAN WEB

vue js, payload cms, nuxtJS

TUGAS NYA LIVE CODING

UAS UTS LIVE CODING

TUGAS
LIVE PROJECT
LIVE CODING
KEAKTIFAN

Project itu ada di praktikumnya

NOTULENSI
Andreas 21 - Jakarta - Apartemen puker - Benerin Nilai - unknown hobi, kepemanduan, hima
Jonathan - Jateng, magelang - perumdos - fotografi hobinya - 19 thn - menaikkan ip
Faishal - bandung - BME - hobi istirahat - bisa dapet nilai bagus, jdi anak sholeh
dhimas - balikpapan - educity - musik hobinya - bisa dapet nilai maks
valent - semarang - sby barat - ngegame - naikkin ip
zahra - gununganyar - musik nyanyi - naikkin ip
silvia - semolowaru - ngegame - mendapatkan nilai bagus
mutiara - madiun - bme - masak - nilai bagus
khansa - bontang - makan masak - paham materi
dani - madiun - sepak bola - meniingkatkan skill coding
afif - malang - perumdos - nge game - jadi lebih baik dari segi kemampuan
Adi - semarang - BME - main musik - bisa dapet nilai bagus
yuma - sragen - musik, piano keyboard - lulus nilai maks
marcell - madiun - keputih - baca manwha - nilai bagus, masuk surga
arka - bontang - baca buku - bisa bikin web, ip tinggi
step - musik - balikpapan - educity - moga dpt ip bagus
caca - perumdos - dpt ilmu maks
etha - sumut - ngerti, ip bagus
rehana - gebang - dengerin musik - bisa ketemu bidang it yg bisa dikembangin
atha - solo - masak - dapet nilai bagus
monica - sumut - asrama - menedaktkan diri dengan alam - bisa nerapin ilmu
leo - jakarta - bme - belajar - hacker
steven - nyanyi - dpt nilai bagus
dwiyasa - sidoarjo - perumdos - baca buku - dpt nilai bagus
michael - surabaya - surabaya - hobi ga ada untk sekarang - satu kelas ip nya bagus aamiinnnnnnnnnnnnnnnnnnnnn
subkan - tuban - aster - Ketiduran tiba tiba (KTT) - expert satu bidang IT, menyenangkan ortu
sidoarjo - asrama mahasiswa its - dengerin musik , ngegame - smg tidak ada masalah, dpt nilai baik
Ridho - sby - hacking, buat alat IOT - bisa kuliah dgn baik, tugas diselesaikan, bisa bikin web, live coding, eas, bikin web, harus bisa

PIMPIN DOA
CATET KEAKTIFAN
KUMPULIN HP
SBLM JAM 10 , KLO ADA YG IJIN , SAKIT, HARUS DIKUMPULKAN SURATNYA
MATIIN AC

Belajar otodidak di portswigger, tryhackme.com

TONTON VIDEONYA SAMPE DI DASAR HTML
